1111111111111111111111111
1111142422221113333111121
1111244422222222222221111
1111122222222222222222221
1113222222222222222222221
1111122222222222222222221
1332233332222222222222221
1111233332222222222222221
1222144422222222222222221
1222114422222222222222221
1222222222222222222222221
1111122222222222222222222
1111222222222222222222222
1112222222233332222222222
1111422222333332332222222
1111222222222222332222222
1112222222222222332222221
1333222222222222222222221
1333222222222222222222221
1333222222222222222222221
1333322222222222222222221
1111442222222222444411121
1111442222222222444111221
1111122222333344444411111
1111111111111111111111111
#Warps:
    #north|south|east|west
|onescreen2|onescreen2|start|onescreen2|

#Events:
    #x,y/tilenumber/message


#Monsters:
    #x,y/(H)ostile or (F)riendly/(D)amageable or (ND)/name/health/attack dmg/speed/image/collideable -T or F
_20,6/H/D/Enemy1/5/2/2/1/T
_15,20/H/D/Enemy2/10/2/2/1/T

#Chests:
    #x,y/item
+1,9/crowbar
#MUST BE A SPACE AT THE BOTTOM

#Doors
{4,10/hands
