1111111111111111111111111
1111111222222222222211111
1111222222222222222221111
1111122222222222222221121
1222222222222222222222221
1222222222222222222222221
1222233332222222222222221
1222233332222222222222221
1222222222222222222222221
1222222222222222222222221
1222333222222222222222221
2222333222222222222222221
2222222222222222222222221
2222222222222222222222222
2222222244442222332222221
2222222244422222332222221
1222222222222222332222221
1222222222222222222222221
1222233333222222222222221
1222333222222222222222221
1222333222222222222222221
1222333333222222222222221
1122222222222222222222221
1111122222222222222211121
1111111122222222111111111

|start|start|upright|upleft|
*4,2/5/Testing the scripting system.

#doors
{23,13/brass knuckle

_20,14/H/D/Enemy1/5/2/2/1/T
_13,5/H/D/Enemy1/5/2/2/1/T
