1111111122222222111111111
1111122122222222422111121
1111222111222444322221111
1222222211222234222222221
1222222222222222222222221
1222222222222222222222221
1222233332222222222222221
1222233332222222222222221
1222222232222222222222221
1222222232222222222222221
1222222232222222222222221
2222222232222222222222222
2222222232222222222222222
2222222232233332222222222
2222222233333332332222222
2222222222222222332222222
1222222222222222332222221
1222222222222222222222221
1222222222222222222222221
1222222222222222222222221
1222222222222222222222221
1111442222222222444411121
1111442222222222444111221
1111122222111122224411111
1111111111111111111111111

#Warps:
    #north|south|east|west
|start|start|start|start|


#Events:
    #y,x/tilenumber/message
*10,9/5/Text



#monsters:
    #x,y/(H)ostile or (F)riendly/(D)amageable or (ND)/name/health/attack dmg/speed/image/collideable -T or F

_20,6/H/D/Enemy1/5/2/2/1/T




#Chests:
    #x,y/item
+13,5/crowbar

#Doors:
    #x,y,key
{12,3/crowbar


#MUST BE A SPACE


