1111111111111111111111111
1111122133344222422111121
1111222111222444322221111
1222222211222232222222221
1222222222222222222222221
1222222222222222222222221
1222211112222222222222221
1222232222222222222222221
1222222222222222222222221
1222222222222222222222221
1222222222222222222222221
1222222222222222222222222
1222222222222222222222222
1222222242233332222222222
1222222242223332332222222
1222222222222222332222222
1222222222222222332222221
1222222222222222222222221
1222222222222222222222221
1222222222222222222222221
1222222222222222222222221
1111112222222222444411121
1111443322222222444111221
1111122222111122224411111
1111111111111111111111111

#Warps:
    #north|south|east|west
|start|start|northofstart|start|


#Events:
    #y,x/tilenumber/message
*10,9/5/Here's some beautifully scripted dialogue



#monsters:
    #x,y/(H)ostile or (F)riendly/(D)amageable or (ND)/name/health/attack dmg/speed/image/collideable -T or F

_20,9/H/D/Enemy1/5/2/2/1/T


#Chests:
    #x,y/item
+13,5/brass knuckle

#Doors:




