1111111111111111111111111
1111122122222222422111121
1111222111222444322221111
1222222211222234222222221
1222222222222222222222221
1222222222222222222222221
1222233332222222222222221
1222233332222222222222221
1222222232222222222222221
1222222222222222222222221
1222222222222222222222221
2222222222222222222222221
2222222222222222222222221
2222222222222222222222221
2222222222222222222222221
2222222222222222222222221
1222222222222222222222221
1222222222222222222222221
1222222222222222222222221
1222222222222222222222221
1222222222222222222222221
1111232222222222332211121
1111322222222222424111221
1111122222111122222411111
1111111111111111111111111

#Warps:
    #north|south|east|west
|start|start|northofstart|start|


#Events:
    #y,x/tilenumber/message
*15,15/5/You win!



#monsters:
    #x,y/(H)ostile or (F)riendly/(D)amageable or (ND)/name/health/attack dmg/speed/image/collideable -T or F



#Chests:
    #x,y/item


#Doors:
    #x,y/key


